лллллллллллллллллллллллллллллллл
л                              л
л лллл   ллл  ллллллллл    ллл л
л л  л     лллл       ллл    л л
л л  лл    л  л         л    л л
л л   л    л  л   лл    лллллл л
л л   л       лл  л       л  л л
л л   ллл      лллл       л  л л
л лл    ллл       л       л  л л
л  л      л       л       л  л л
л  л      лллл    ллл   ллл  л л
л ллллл      ллл  л     л    л л
л л            л  л    лл    л л
л л      лл    л  ллл  л     л л
л л  л  лл     л       л     л л
л лллл  л      л       л  л  л л
л    л  л          ллллл  л  л л
л    л  л          л   л  лллл л
л лллл  лл   лллл  л   л  л    л
л   л    л   л  ллллл     л    л
л   л    лл  л            л  л л
л ллл     л  л          ллл  л л
л л       л  лллл  ллл  л    л л
л л    лллл  л  л    л  л    л л
л л    л  л  л  л    лллл   лл л
л л    л  лллл  л    л      л  л
л ллл     л     л    л     лл  л
л   л           л  ллллллллл   л
л   ллл        лл  л    л  л   л
л     лллллллллл   л    л  ллл л
л                              л
лллллллллллллллллллллллллллллллл
