                                
                               л
  лл  лллллллллллл   лллл    л л
   лллл       л  лл  л  лл   л л
   л          л  л   л  л   лл л
  лл     л   лл  л   л  л   л  л
  л     лл  лл   л  лл  ллллл  л
  л   ллл   л    л  л    л  лл л
  ллллл     л       л    л   л л
    л      лллл     л  ллл   л л
    л      л  лл   лл  л    лл л
    л  ллллл      лл        л  л
  ллл  л   л      л       ллл  л
  л    л   лл   ллл   л     лл л
       л    л  лл    ллл     л л
     ллл    л  л       ллл   л л
  лллл    ллл            ллллл л
  л                 л    л     л
  л            л    лллллл     л
  л  лллллллллллллллл        л л
  лллл                      лл л
  л                      лллл  л
  л     лллл  л  лллллл  л  л  л
  лл    л  л  л  л    л  л  лл л
  л   ллл  ллллллл    лллл  л  л
  л    л                    л  л
  лл                        л  л
   лл       ллллл   л  лллллл  л
    л   ллллл   л   л  л    лл л
    ллллл   л   лллллллл     л л
                               л
 ллллллллллллллллллллллллллллллл
